....................................................................................................
....................................................................................................
....................................................................................................
....................................................................................................
....................................................................................................
..................................................................B.................................
....................................................................................................
....................................................................................................
......................WWWWWWWWW.....................................................................
......................WWWWWWWWW.....................................................................
..........................W.........................................................................
..........................W........................................................................E
S.........................W................................................#WWWWWWWWWWWWWWWWWWWWWWWW
WWWWWWWWWWWWWWWWWWWWWWWWW.W................................................#.......................W
..........................W................................................#.......................W
..........................W...................A............................#.......................W
..........................W#WWWWWWWWWWWWWWWWWWWWWWWWWWWWWWWWWWWW...........#.......................W
...........................#...............................................#.......................W
.........................WW.......................................W........#.......................W
................................................................LLLWWWWWWWWWWWWWWWWWWW.............W
................................................................LLLWWWWWWWWWWWWWWWWWWW.............W
..............LLLLLLLLLLLL......................................LLLWWWWWWWWWWWWWWWWWWW.............W
............WWWWWWWWWWWWWWWWWWWWWWWWWWWWWWWWWWWWWWWWWWWWWWWWWWWWWWWWWWWWWWWWWWWWWWWWWWWWWWWWWWWWWWWW
....................................................................................................
....................................................................................................
....................................................................................................
....................................................................................................
....................................................................................................
....................................................................................................
....................................................................................................
....................................................................................................