....................................................................................................
....................................................................................................
....................................................................................................
....................................................................................................
...............................................................WW...................................
...............................................................WW...................................
...............................................................WW...................................
...............................................................WW...................................
................................WW.......W.....................WW...................................
..............................WWWW.WWWWWWWWWWWWWWWWWWWWWWWWWW..WW...................................
............................WWWWWW..................................................................
..........................WWWWWWWW.............................WW...................................
S.......................WWWWWWWWWW.............................WW...................................
WWWWWWWWWWWWWWWWWWWWWWWWWWWWWWWWWWWWWWWWWWLWWWWWWWWWWWWWWWWWWWWWWWWWWWWWWWWWWWWWWWWWWWWWWWWWWWWWWWWW
....................................................................................................
..........................................W.........................................................
.............................WWWWWWWWWWWWWWWWWWWWWWWWWWWWWWWWWWW....................................
B.......................................................WWWWWWWW...................................E
WWWWWWWWWWWWWWWWWWWWWWWW..WW.WWWWWWWW.WWWWWWWWWWWWWWWW..WWWWWWWW.......................WWWWWWWWWWWWW
..........................WW.........................................................WWWWWWWWWWWWWWW
.......................WWWWW..........W.................WWWWWWWW...................WWWWWWWWWWWWWWWWW
.......................LLLLLLWWWWWWWWWWWWWWWWWWWWWWWWWWWWWWWWWWWWWWWWWWWWWWWWWWWWWWWWWWWWWWWWWWWWWWW
....................................................................................................
....................................................................................................
....................................................................................................
....................................................................................................
....................................................................................................
....................................................................................................
....................................................................................................
....................................................................................................
....................................................................................................