S 
%%%%%
                    %%%%%%%

        %%%%%%%%
        %%%%%%%%
                

                    %%%%%%%
                    %%%%%%%


                            %%%%%%%
                            %%%%%%%


                                        %%%%%%%%%%%%
                                        %%%%%%%%%%%%







                                                                                                  X
                                                                                           %%%%%%%%

