....................................................................................................
....................................................................................................
....................................................................................................
....................................................................................................
....................................................................................................
....................................................................................................
....................................................................................................
....................................................................................................
..........WWWWWWWWWWWWWWWWWWWWWWWW.WWWWWWWWWWWWWWWWWWWWWWWWWW.......................................
S.........WWWWWWWWWWWWWWWWWWWWWWWW.WWWWWWWWWWWWWWWWWWWWWWWWWW.WWWWWWWWWWWWWWWWWWWWWWWWWWWWW.........
WWWWWWWWW...........................................................................................
..................................W.................................................................
....................................................................................................
..........WWWWWWWWW.WWWWWWW.WWWWWWWWWWWW.WWWWWWWWWWWWWWWWWWWW.WWWWWWWWWWWWWWWWWWWWWWWWWWWWW.........
.........WWWWWWWWWW.WWWWWWW.WWWWWWWWWWWW.WWWWWWWWWWWWWWWWW..W.W.....................................
.........................................WWWWWWWWWWWWWWWWW..WWW.....................................
...........................WWWWWWWWWW...WWWWWWWWWWWWWWWWWW..........................................
....................................................................................................
....................................WWWWWWWWWWWWWWWWWWW............................................E
............................................................................................WWWWWWWW
........WWWWWWWWWWWW........................................................................WW......
.......................W....................................................................WW......
..................WWWWWWWWWWWWWWWWWWWWWWWWWWWWWWWWWWWWWWWWWWWWWWWWWWWWWWWWWWWWWWWWWWWWWWWWWWWW......
....................................................................................................
....................................................................................................
....................................................................................................
....................................................................................................
....................................................................................................
....................................................................................................
....................................................................................................
....................................................................................................
....................................................................................................