....................................................................................................
....................................................................................................
....................................................................................................
....................................................................................................
...............................................................WW...................ZZZZZZ..........
...............................................................WW...................ZZZZZZ..........
...............................................................WW...................ZZZZZZ..........
...............................................................WW...................ZZZZZZ..........
...............................#WW.......W.....................WW...................ZZZZZZ..........
.............................#WWWW.WWWWWWWWWWWWWWWWWWWWWWWWWW..WW...................ZZZZZZ..........
...........................#WWWWWW..................................................ZZZZZZ..........
.........................#WWWWWWWW............................#WW...................ZZZZZZ..........
S......................#WWWWWWWWWW........#...................#WW...................ZZZAZZ..........
WWWWWWWWWWWWWWWWWWWWWWWWWWWWWWWWWWWWWWWWWWLWWWWWWWWWWWWWWWWWWWWWWWWWWWWWWWWWWWWWWWWWWWWWWWWWWWWWWWWW
....................................................................................................
..........................................W.........................................................
.............................WWWWWWWWWWWWWWWWWWWWWWWWWWWWWWWWWWW....................................
B.......................................................WWWWWWWW...................................E
WWWWWWWWWWWWWWWWWWWWWWWWWWWWWWWWWWWWW.WWWWWWWWWWWWWWWW..WWWWWWWW......................#WWWWWWWWWWWWW
..........................WW........................................................#WWWWWWWWWWWWWWW
.......................WWWWW..........W................#WWWWWWWW..................#WWWWWWWWWWWWWWWWW
.......................LLLLLLWWWWWWWWWWWWWWWWWWWWWWWWWWWWWWWWWWWWWWWWWWWWWWWWWWWWWWWWWWWWWWWWWWWWWWW
....................................................................................................
....................................................................................................
....................................................................................................
....................................................................................................
....................................................................................................
....................................................................................................
....................................................................................................
....................................................................................................
....................................................................................................