....................................................................................................
....................................................................................................
....................................................................................................
....................................................................................................
...............................................................WW...................ZZZZZZ..........
...............................................................WW...................ZZZZZZ..........
...............................................................WW...................ZZZZZZ..........
...............................................................WW...................ZZZZZZ..........
...............................#WW.......W.....................WW...................ZZZZZZ..........
.............................#WWWW.WWWWWWWWWWWWWWWWWWWWWWWWWW..WW...................ZZZZZZ..........
...........................#WWWWWW..................................................ZZZZZZ..........
.........................#WWWWWWWW............................#WW...................ZZZZZZ..........
S......................#WWWWWWWWWW........#...................#WW...................ZZZZZA..........
WWWWWWWWWWWWWWWWWWWWWWWWWWWWWWWWWWWWWWWWWWLWWWWWWWWWWWWWWWWWWWWWWWWWWWWWWWWWWWWWWWWWWWWWWWWWWWWWWWWW
....................................................................................................
.........................................#W.........................................................
............................#WWWWWWWWWWWWWWWWWWWWWWWWWWWWWWWWWWW....................................
B...........................#...........................WWWWWWWW...................................E
WWWWWWWWWWWWWWWWWWWWWWWWWWWW.WWWWWWWW.WWWWWWWWWWWWWWWW..WWWWWWWW......................#WWWWWWWWWWWWW
..........................WW........................................................#WWWWWWWWWWWWWWW
.......................WWWWW..........W.................WWWWWWWW..................#WWWWWWWWWWWWWWWWW
.......................LLLLLLWWWWWWWWWWWWWWWWWWWWWWWWWWWWWWWWWWWWWWWWWWWWWWWWWWWWWWWWWWWWWWWWWWWWWWW
....................................................................................................
....................................................................................................
....................................................................................................
....................................................................................................
....................................................................................................
....................................................................................................
....................................................................................................
....................................................................................................
....................................................................................................